button-accept-jobs.gif              green     Aceptar trabajos
button-add-class.gif 	            standard  Añadir clase
button-add-printer.gif 	            standard  Añadir impresora
button-add-rss-subscription.gif     standard  Añadir subscripción RSS
button-add-this-printer.gif         standard  Añadir esta impresora
button-cancel-all-jobs.gif 	    black     Cancelar todos los trabajos
button-cancel-job.gif 	            black     Cancelar trabajo
button-cancel-subscription.gif      standard  Cancelar subscripción
button-change-settings.gif 	    standard  Cambiar especificaciones
button-clean-print-heads.gif 	    standard  Limpiar cabezales de impresión
button-clear.gif 	            standard  Borrar
button-continue.gif 	            standard  Siguiente
button-delete-class.gif 	    black     Borrar clase
button-delete-printer.gif 	    black     Borrar impresora
button-edit-configuration-file.gif  standard  Editar archivo configuración
button-export-samba.gif 	    standard  Exportar impresoras a Samba
button-find-new-printers.gif        standard  Encontrar nuevas impresoras
button-help.gif 	            standard  Ayuda
button-hold-job.gif 	            red       Retener trabajo
button-manage-classes.gif 	    standard  Administrar clases
button-manage-jobs.gif 	            standard  Administrar trabajos
button-manage-printers.gif 	    standard  Administrar impresoras
button-manage-server.gif 	    standard  Administrar servidor
button-modify-class.gif 	    standard  Modificar clase
button-modify-printer.gif 	    standard  Modificar impresora
button-move-job.gif 	            standard  Mover trabajo
button-move-jobs.gif 	            standard  Mover todos los trabajos
button-print-self-test-page.gif     standard  Imprimir página de auto prueba
button-print-test-page.gif 	    standard  Imprimir página de prueba
button-publish-printer.gif 	    standard  Publicar impresora
button-reject-jobs.gif 	            red       Rechazar trabajos
button-release-job.gif 	            green     Liberar trabajo
button-restart-job.gif 	            standard  Reimprimir trabajo
button-save-changes.gif 	    standard  Guardar cambios
button-search.gif 	            standard  Buscar
button-set-allowed-users.gif 	    standard  Cambiar usuarios permitidos
button-set-as-default.gif 	    standard  Poner como predeterminada
button-set-printer-options.gif 	    standard  Cambiar opciones impresora
button-show-active.gif 	            standard  Mostrar trabajos activos
button-show-all.gif 	            standard  Mostrar todos los trabajos
button-show-completed.gif 	    standard  Mostrar trabajos completados
button-show-next.gif 	            standard  Mostrar siguiente
button-show-previous.gif 	    standard  Mostrar anterior
button-sort-ascending.gif 	    standard  @UP Orden ascendente @UP
button-sort-descending.gif 	    standard  @DOWN Orden descendente @DOWN
button-start-class.gif 	            green     Iniciar clase
button-start-printer.gif 	    green     Iniciar impresora
button-stop-class.gif 	            red       Detener clase
button-stop-printer.gif 	    red       Detener impresora
button-unpublish-printer.gif 	    standard  No publicar impresora
button-use-default-config.gif 	    standard  Usar archivo de configuración predeterminado
button-view-access-log.gif 	    standard  Ver archivo de registro de accesos
button-view-error-log.gif 	    standard  Ver archivo de registro de errores
button-view-page-log.gif 	    standard  Ver archivo de registro de páginas
button-view-printable-version.gif   standard  Ver versión imprimible
